18 18 07 08 08 08 07 07 07 07 07 07 07 07 07 07 07 07 07 07 07 07 07 07 07 07 07 08 08 08 08 08 08 08 08 07 18 18
18 18 07 08 08 08 07 07 07 07 07 07 07 07 07 07 07 07 07 07 07 07 07 07 07 07 07 08 08 08 08 08 08 08 08 07 18 18
18 18 07 08 08 08 08 08 08 08 08 08 08 08 08 08 08 08 07 07 08 08 08 08 08 08 08 08 08 08 08 08 08 08 08 07 18 18
18 18 07 08 08 08 08 08 08 08 08 08 08 07 00 00 00 00 00 00 00 00 00 00 07 08 08 08 08 08 08 08 08 08 08 07 18 18
18 18 07 08 08 08 08 08 08 08 08 08 08 07 00 00 00 00 00 00 00 00 00 00 07 08 08 08 08 08 08 08 08 08 08 07 18 18
18 18 07 07 07 07 07 07 07 07 07 07 07 07 00 00 00 00 00 00 00 00 00 00 07 07 07 07 07 07 07 07 07 07 07 07 18 18
17 17 17 17 17 17 17 17 17 17 17 17 18 07 00 00 00 00 00 00 00 00 00 00 07 18 17 17 17 17 17 17 17 17 17 17 17 17
18 18 20 20 20 20 20 20 20 20 20 17 18 07 07 07 07 00 00 00 00 07 07 07 07 18 17 20 20 20 20 20 20 20 20 20 18 18
18 18 18 18 20 18 18 18 20 18 18 17 18 19 19 19 07 00 00 00 00 07 19 19 19 18 17 18 18 20 18 20 18 18 18 20 18 18
18 18 20 18 20 18 20 20 20 18 20 17 18 19 19 19 07 00 00 00 00 07 19 19 19 18 17 20 18 20 18 20 18 20 18 20 18 18
18 18 20 18 20 18 20 18 18 18 20 17 18 19 19 19 07 00 00 00 00 07 19 19 19 18 17 20 18 18 18 20 18 20 18 20 18 18
18 18 20 18 20 18 20 18 20 18 20 15 18 19 19 19 07 00 00 00 00 07 19 19 19 18 13 20 18 20 18 20 18 20 18 20 18 18
18 18 20 18 20 18 20 18 20 20 20 16 18 19 19 19 07 00 00 00 00 07 19 19 19 18 14 20 20 20 18 20 18 20 18 18 18 18
18 18 20 18 20 18 20 18 18 18 20 17 18 19 19 19 07 00 00 00 00 07 19 19 19 18 17 20 18 18 18 20 18 20 20 20 18 18
18 18 20 18 20 18 20 20 20 18 20 17 18 19 19 19 07 00 00 00 00 07 19 19 19 18 17 20 18 20 20 20 18 20 18 20 18 18
18 18 20 18 18 18 20 18 20 18 20 17 18 19 19 19 07 00 00 00 00 07 19 19 19 18 17 20 18 20 18 20 18 18 18 20 18 18
18 18 20 20 20 18 20 18 18 18 20 15 18 19 19 19 07 00 00 00 00 07 19 19 19 18 13 20 18 18 18 20 18 20 20 20 18 18
18 18 20 18 18 18 20 20 20 18 20 16 18 19 19 19 07 00 00 00 00 07 19 19 19 18 14 20 18 20 20 20 18 18 18 20 18 18
18 18 20 18 20 18 18 18 18 18 20 17 18 19 19 19 07 00 00 00 00 07 19 19 19 18 17 20 18 18 18 18 18 20 18 20 18 18
18 18 20 20 20 20 20 20 20 20 20 17 18 18 18 18 07 00 00 00 00 07 18 18 18 18 17 20 20 20 20 20 20 20 20 20 18 18
18 18 18 18 18 18 18 18 18 18 18 17 17 17 17 18 07 00 00 00 00 07 18 17 17 17 17 18 18 18 18 18 18 18 18 18 18 18
18 18 18 18 18 18 18 18 18 18 18 17 17 17 17 18 07 00 00 00 00 07 18 17 17 17 17 18 18 18 18 18 18 18 18 18 18 18
17 17 17 17 17 17 17 17 17 17 17 17 17 17 17 18 07 00 00 00 00 07 18 17 17 17 17 17 17 17 17 17 17 17 17 17 17 17
17 17 17 17 17 17 17 17 17 17 17 17 17 17 17 18 07 00 00 00 00 07 18 17 17 17 17 17 17 17 17 17 17 17 17 17 17 17
17 17 17 17 17 17 17 17 17 17 17 17 17 17 17 18 07 00 00 00 00 07 18 17 17 17 17 17 17 17 17 17 17 17 17 17 17 17
17 17 17 17 17 17 17 17 17 17 17 17 17 17 17 18 07 00 00 00 00 07 18 17 17 17 17 17 17 17 17 17 17 17 17 17 17 17
20 20 20 20 17 20 20 20 20 20 20 20 20 20 20 20 07 00 00 00 00 07 20 20 20 20 20 20 20 20 20 20 20 20 20 20 20 20
17 17 17 17 17 17 17 17 17 17 17 17 17 17 17 18 07 00 00 00 00 07 18 17 17 17 17 17 17 17 17 17 17 17 17 17 17 17
17 17 17 17 17 17 17 17 17 17 17 17 17 17 17 18 07 00 00 00 00 07 18 17 17 17 17 17 17 17 17 17 17 17 17 17 17 17
17 17 17 17 17 17 17 17 17 17 17 17 17 17 17 18 07 00 00 00 00 07 18 17 17 17 17 17 17 17 17 17 17 17 17 17 17 17
17 17 17 17 17 17 17 17 17 17 17 17 17 17 17 18 07 00 00 00 00 07 18 17 17 17 17 17 17 17 17 17 17 17 17 17 17 17
18 18 18 18 18 18 18 18 18 18 18 18 18 18 18 18 07 00 00 00 00 07 18 18 18 18 18 18 18 18 18 18 18 18 18 18 18 18
18 18 18 18 18 18 18 18 18 18 18 18 18 18 18 18 07 00 00 00 00 07 18 18 18 18 18 18 18 18 18 18 18 18 18 18 18 18
18 18 18 18 18 18 18 18 18 18 18 18 18 18 18 18 07 00 00 00 00 07 18 18 18 18 18 18 18 18 18 18 18 18 18 18 18 18
18 18 18 18 18 18 18 18 18 18 18 18 18 18 18 18 07 00 00 00 00 07 18 18 18 18 18 18 18 18 18 18 18 18 18 18 18 18
18 18 18 18 18 18 18 18 18 18 18 18 18 18 18 18 07 00 00 00 00 07 18 18 18 18 18 18 18 18 18 18 18 18 18 18 18 18
18 18 18 18 18 18 18 18 18 18 18 18 18 18 18 18 07 00 00 00 00 07 18 18 18 18 18 18 18 18 18 18 18 18 18 18 18 18
18 18 18 18 18 18 18 18 18 18 18 18 18 18 18 18 07 00 00 00 00 07 18 18 18 18 18 18 18 18 18 18 18 18 18 18 18 18
18 18 18 18 18 18 18 18 18 18 18 18 18 18 18 18 07 00 00 00 00 07 18 18 18 18 18 18 18 18 18 18 18 18 18 18 18 18
18 18 18 18 18 18 18 18 18 18 18 18 18 18 18 18 07 00 00 00 00 07 18 18 18 18 18 18 18 18 18 18 18 18 18 18 18 18
18 18 18 18 18 18 18 18 18 18 18 18 18 18 18 18 07 00 00 00 00 07 18 18 18 18 18 18 18 18 18 18 18 18 18 18 18 18
18 18 18 18 18 18 18 18 18 18 18 18 18 18 18 18 07 00 00 00 00 07 18 18 18 18 18 18 18 18 18 18 18 18 18 18 18 18
07 07 07 07 07 07 07 07 07 07 07 07 07 07 07 07 07 00 00 00 00 07 07 07 07 07 07 07 07 07 07 07 07 07 07 07 07 07
00 00 00 00 00 00 00 00 00 00 00 00 00 00 00 00 00 00 00 00 00 00 00 00 00 00 00 00 00 00 00 00 00 00 00 00 00 00
00 00 00 00 00 00 00 00 00 00 00 00 00 00 00 00 00 00 00 00 00 00 00 00 00 00 00 00 00 00 00 00 00 00 00 00 00 00
00 00 00 00 00 00 00 00 00 00 00 00 00 00 00 00 00 00 00 00 00 00 00 00 00 00 00 00 00 00 00 00 00 00 00 00 00 00
00 00 00 00 00 00 00 00 00 00 00 00 00 00 00 00 00 00 00 00 00 00 00 00 00 00 00 00 00 00 00 00 00 00 00 00 00 00
07 07 07 07 07 07 07 07 07 07 07 07 07 07 07 07 07 07 07 07 07 07 07 07 07 07 07 07 07 07 07 07 07 07 07 07 07 07
18 18 18 18 18 18 18 18 18 18 18 18 18 18 18 18 18 18 18 18 18 18 18 18 18 18 18 18 18 18 18 18 18 18 18 18 18 18
18 18 18 18 18 18 18 18 18 18 18 18 18 18 18 18 18 18 18 18 18 18 18 18 18 18 18 18 18 18 18 18 18 18 18 18 18 18
18 18 18 18 18 18 18 18 18 18 18 18 18 18 18 18 18 18 18 18 18 18 18 18 18 18 18 18 18 18 18 18 18 18 18 18 18 18
18 18 18 18 18 18 18 18 18 18 18 18 18 18 18 18 18 18 18 18 18 18 18 18 18 18 18 18 18 18 18 18 18 18 18 18 18 18
18 18 18 18 18 18 18 18 18 18 18 18 18 18 18 18 18 18 18 18 18 18 18 18 18 18 18 18 18 18 18 18 18 18 18 18 18 18
18 18 18 18 18 18 18 18 18 18 18 18 18 18 18 18 18 18 18 18 18 18 18 18 18 18 18 18 18 18 18 18 18 18 18 18 18 18
18 18 18 18 18 18 18 18 18 18 18 18 18 18 18 18 18 18 18 18 18 18 18 18 18 18 18 18 18 18 18 18 18 18 18 18 18 18
18 18 18 18 18 18 18 18 18 18 18 18 18 18 18 18 18 18 18 18 18 18 18 18 18 18 18 18 18 18 18 18 18 18 18 18 18 18
18 18 18 18 18 18 18 18 18 18 18 18 18 18 18 18 18 18 18 18 18 18 18 18 18 18 18 18 18 18 18 18 18 18 18 18 18 18
18 18 18 18 18 18 18 18 18 18 18 18 18 18 18 18 18 18 18 18 18 18 18 18 18 18 18 18 18 18 18 18 18 18 18 18 18 18
18 18 18 18 18 18 18 18 18 18 18 18 18 18 18 18 18 18 18 18 18 18 18 18 18 18 18 18 18 18 18 18 18 18 18 18 18 18
18 18 18 18 18 18 18 18 18 18 18 18 18 18 18 18 18 18 18 18 18 18 18 18 18 18 18 18 18 18 18 18 18 18 18 18 18 18
18 18 18 18 18 18 18 18 18 18 18 18 18 18 18 18 18 18 18 18 18 18 18 18 18 18 18 18 18 18 18 18 18 18 18 18 18 18
18 18 18 18 18 18 18 18 18 18 18 18 18 18 18 18 18 18 18 18 18 18 18 18 18 18 18 18 18 18 18 18 18 18 18 18 18 18
18 18 18 18 18 18 18 18 18 18 18 18 18 18 18 18 18 18 18 18 18 18 18 18 18 18 18 18 18 18 18 18 18 18 18 18 18 18
18 18 18 18 18 18 18 18 18 18 18 18 18 18 18 18 18 18 18 18 18 18 18 18 18 18 18 18 18 18 18 18 18 18 18 18 18 18
18 18 18 18 18 18 18 18 18 18 18 18 18 18 18 18 18 18 18 18 18 18 18 18 18 18 18 18 18 18 18 18 18 18 18 18 18 18
18 18 18 18 18 18 18 18 18 18 18 18 18 18 18 18 18 18 18 18 18 18 18 18 18 18 18 18 18 18 18 18 18 18 18 18 18 18
18 18 18 18 18 18 18 18 18 18 18 18 18 18 18 18 18 18 18 18 18 18 18 18 18 18 18 18 18 18 18 18 18 18 18 18 18 18
18 18 18 18 18 18 18 18 18 18 18 18 18 18 18 18 18 18 18 18 18 18 18 18 18 18 18 18 18 18 18 18 18 18 18 18 18 18