10 20 10 10 73 11 19 11 12 12 11 10 11 12 10 11 10 10 12 12 10 11 10 10 12 11 10 11 12 12 11 10 11 12 10 11 10 10 12 12
10 11 16 10 73 11 10 11 12 12 11 10 11 12 10 11 10 10 12 12 10 11 10 10 12 11 10 11 12 12 11 10 11 12 10 11 10 10 12 12
10 11 19 10 73 11 10 11 12 12 11 10 11 12 10 11 10 10 12 12 10 11 10 10 12 11 10 11 12 12 11 10 11 12 10 11 10 10 12 12
10 11 10 17 73 11 10 11 12 12 11 10 11 12 10 11 10 10 12 12 10 11 10 10 12 11 10 11 12 12 11 10 11 12 10 11 10 10 12 12
10 18 10 10 73 11 10 11 12 12 11 10 11 12 10 11 10 10 12 12 10 11 10 10 12 11 10 11 12 12 11 10 11 12 10 11 10 10 12 12
10 11 18 10 73 11 10 11 12 12 11 10 11 12 10 11 10 10 12 12 10 11 10 10 12 11 10 11 12 12 11 10 11 12 10 11 10 10 12 12
10 14 10 10 73 11 10 11 12 12 11 10 11 12 10 11 10 10 12 12 10 11 10 10 12 11 10 11 12 12 11 10 11 12 10 11 10 10 12 12
17 11 10 10 73 11 10 11 12 12 11 10 11 12 10 11 10 10 12 12 10 11 10 10 12 11 10 11 12 12 11 10 11 12 10 11 10 10 12 12
10 11 10 10 73 11 10 11 12 12 11 10 11 12 10 11 10 10 12 12 10 11 10 10 12 11 10 11 12 12 11 10 11 12 10 11 10 10 12 12
10 11 10 10 73 11 10 11 12 12 11 10 11 12 10 11 10 10 12 12 10 11 10 10 12 11 10 11 12 12 11 10 11 12 10 11 10 10 12 12
10 11 10 10 73 11 10 11 12 12 11 10 11 12 10 11 10 10 12 12 10 11 10 10 12 11 10 11 12 12 11 10 11 12 10 11 10 10 12 12
10 11 10 10 73 11 10 11 12 12 11 10 11 12 10 11 10 10 12 12 10 11 10 10 12 11 10 11 12 12 11 10 11 12 10 11 10 10 12 12
10 11 10 10 73 11 10 11 12 12 11 10 11 12 10 11 10 10 12 12 10 11 10 10 12 11 10 11 12 12 11 10 11 12 10 11 10 10 12 12
10 11 10 10 73 11 10 11 12 12 11 10 11 12 10 11 10 10 12 12 10 11 10 10 12 11 10 11 12 12 11 10 11 12 10 11 10 10 12 12
10 11 10 10 73 11 10 11 12 12 11 10 11 12 10 11 10 10 12 12 10 11 10 10 12 11 10 11 12 12 11 10 11 12 10 11 10 10 12 12
10 11 10 10 73 12 10 11 12 12 11 10 11 12 10 11 10 10 12 12 10 11 10 10 12 11 10 11 12 12 11 10 11 12 10 11 10 10 12 12
10 11 10 10 73 11 10 11 12 12 11 10 11 12 10 11 10 10 12 12 10 11 10 10 12 11 10 11 12 12 11 10 11 12 10 11 10 10 12 12
10 11 10 10 73 11 10 11 12 12 11 10 11 12 10 11 10 10 12 12 10 11 10 10 12 11 10 11 12 12 11 10 11 12 10 11 10 10 12 12
10 11 10 10 73 11 10 11 12 12 11 10 11 12 10 11 10 10 12 12 10 11 10 10 12 11 10 11 12 12 11 10 11 12 10 11 10 10 12 12
10 11 10 10 73 11 10 11 12 12 11 10 11 12 10 11 10 10 12 12 10 11 10 10 12 11 10 11 12 12 11 10 11 12 10 11 10 10 12 12
10 11 10 10 73 11 10 11 12 12 11 10 11 12 10 11 10 10 12 12 10 11 10 10 12 11 10 11 12 12 11 10 11 12 10 11 10 10 12 12
10 11 10 10 73 11 10 11 12 12 11 10 11 12 10 11 10 10 12 12 10 11 10 10 12 11 10 11 12 12 11 10 11 12 10 11 10 10 12 12
10 11 10 10 73 11 10 11 12 12 11 10 11 12 10 11 10 10 12 12 10 11 10 10 12 11 10 11 12 12 11 10 11 12 10 11 10 10 12 12
10 11 10 10 73 11 10 11 12 12 11 10 11 12 10 11 10 10 12 12 10 11 10 10 12 11 10 11 12 12 11 10 11 12 10 11 10 10 12 12
10 11 10 10 73 11 10 11 12 12 11 10 11 12 10 11 10 10 12 12 10 11 10 10 12 11 10 11 12 12 11 10 11 12 10 11 10 10 12 12
10 11 10 10 73 11 10 11 12 12 11 10 11 12 10 11 10 10 12 12 10 11 10 10 12 11 10 11 12 12 11 10 11 12 10 11 10 10 12 12
10 11 10 10 73 11 10 11 12 12 11 10 11 12 10 11 10 10 12 12 10 11 10 10 12 11 10 11 12 12 11 10 11 12 10 11 10 10 12 12
10 11 10 10 73 11 10 11 12 12 11 10 11 12 10 11 10 10 12 12 10 11 10 10 12 11 10 11 12 12 11 10 11 12 10 11 10 10 12 12
10 11 10 10 73 11 10 11 12 12 11 10 11 12 10 11 10 10 12 12 10 11 10 10 12 11 10 11 12 12 11 10 11 12 10 11 10 10 12 12
10 11 10 10 73 11 10 11 12 12 11 10 11 12 10 11 10 10 12 12 10 11 10 10 12 11 10 11 12 12 11 10 11 12 10 11 10 10 12 12
10 11 10 10 73 11 10 11 12 12 11 10 11 12 10 11 10 10 12 12 10 11 10 10 12 11 10 11 12 12 11 10 11 12 10 11 10 10 12 12
10 11 10 10 73 11 10 11 12 12 11 10 11 12 10 11 10 10 12 12 10 11 10 10 12 11 10 11 12 12 11 10 11 12 10 11 10 10 12 12
10 11 10 10 73 11 10 11 12 12 11 10 11 12 10 11 10 10 12 12 10 11 10 10 12 11 10 11 12 12 11 10 11 12 10 11 10 10 12 12
10 11 10 10 73 11 10 11 12 12 11 10 11 12 10 11 10 10 12 12 10 11 10 10 12 11 10 11 12 12 11 10 11 12 10 11 10 10 12 12
10 11 10 10 73 11 10 11 12 12 11 10 11 12 10 11 10 10 12 12 10 11 10 10 12 11 10 11 12 12 11 10 11 12 10 11 10 10 12 12
10 11 10 10 73 11 10 11 12 12 11 10 11 12 10 11 10 10 12 12 10 11 10 10 12 11 10 11 12 12 11 10 11 12 10 11 10 10 12 12
10 11 10 10 73 11 10 11 12 12 11 10 11 12 10 11 10 10 12 12 10 11 10 10 12 11 10 11 12 12 11 10 11 12 10 11 10 10 12 12
10 11 10 10 73 11 10 11 12 12 11 10 11 12 10 11 10 10 12 12 10 11 10 10 12 11 10 11 12 12 11 10 11 12 10 11 10 10 12 12
10 11 10 10 73 11 10 11 12 12 11 10 11 12 10 11 10 10 12 12 10 11 10 10 12 11 10 11 12 12 11 10 11 12 10 11 10 10 12 12
10 11 10 10 73 11 10 11 12 12 11 10 11 12 10 11 10 10 12 12 10 11 10 10 12 11 10 11 12 12 11 10 11 12 10 11 10 10 12 12
10 11 10 10 73 11 10 11 12 12 11 10 11 12 10 11 10 10 12 12 10 11 10 10 12 11 10 11 12 12 11 10 11 12 10 11 10 10 12 12
10 11 10 10 73 11 10 11 12 12 11 10 11 12 10 11 10 10 12 12 10 11 10 10 12 11 10 11 12 12 11 10 11 12 10 11 10 10 12 12
10 11 10 10 73 11 10 11 12 12 11 10 11 12 10 11 10 10 12 12 10 11 10 10 12 11 10 11 12 12 11 10 11 12 10 11 10 10 12 12
10 11 10 10 73 11 10 11 12 12 11 10 11 12 10 11 10 10 12 12 10 11 10 10 12 11 10 11 12 12 11 10 11 12 10 11 10 10 12 12
10 11 10 10 73 11 10 11 12 12 11 10 11 12 10 11 10 10 12 12 10 11 10 10 12 11 10 11 12 12 11 10 11 12 10 11 10 10 12 12
10 11 10 10 73 11 10 11 12 12 11 10 11 12 10 11 10 10 12 12 10 11 10 10 12 11 10 11 12 12 11 10 11 12 10 11 10 10 12 12
10 11 10 10 73 11 10 11 12 12 11 10 11 12 10 11 10 10 12 12 10 11 10 10 12 11 10 11 12 12 11 10 11 12 10 11 10 10 12 12
10 11 10 10 73 11 10 11 12 12 11 10 11 12 10 11 10 10 12 12 10 11 10 10 12 11 10 11 12 12 11 10 11 12 10 11 10 10 12 12
10 11 10 10 73 11 10 11 12 12 11 10 11 12 10 11 10 10 12 12 10 11 10 10 12 11 10 11 12 12 11 10 11 12 10 11 10 10 12 12
10 11 10 10 73 11 10 11 12 12 11 10 11 12 10 11 10 10 12 12 10 11 10 10 12 11 10 11 12 12 11 10 11 12 10 11 10 10 12 12
10 11 10 10 73 11 10 11 12 12 11 10 11 12 10 11 10 10 12 12 10 11 10 10 12 11 10 11 12 12 11 10 11 12 10 11 10 10 12 12
10 11 10 10 73 11 10 11 12 12 11 10 11 12 10 11 10 10 12 12 10 11 10 10 12 11 10 11 12 12 11 10 11 12 10 11 10 10 12 12
10 11 10 10 73 11 10 11 12 12 11 10 11 12 10 11 10 10 12 12 10 11 10 10 12 11 10 11 12 12 11 10 11 12 10 11 10 10 12 12
10 11 10 10 73 11 10 11 12 12 11 10 11 12 10 11 10 10 12 12 10 11 10 10 12 11 10 11 12 12 11 10 11 12 10 11 10 10 12 12
10 11 10 10 73 11 10 11 12 12 11 10 11 12 10 11 10 10 12 12 10 11 10 10 12 11 10 11 12 12 11 10 11 12 10 11 10 10 12 12
10 11 10 10 73 11 10 11 12 12 11 10 11 12 10 11 10 10 12 12 10 11 10 10 12 11 10 11 12 12 11 10 11 12 10 11 10 10 12 12
10 11 10 10 73 11 10 11 12 12 11 10 11 12 10 11 10 10 12 12 10 11 10 10 12 11 10 11 12 12 11 10 11 12 10 11 10 10 12 12
10 11 10 10 73 11 10 11 12 12 11 10 11 12 10 11 10 10 12 12 10 11 10 10 12 11 10 11 12 12 11 10 11 12 10 11 10 10 12 12
10 11 10 10 73 11 10 11 12 12 11 10 11 12 10 11 10 10 12 12 10 11 10 10 12 11 10 11 12 12 11 10 11 12 10 11 10 10 12 12
10 11 10 10 73 11 10 11 12 12 11 10 11 12 10 11 10 10 12 12 10 11 10 10 12 11 10 11 12 12 11 10 11 12 10 11 10 10 12 12
10 11 10 10 73 11 10 11 12 12 11 10 11 12 10 11 10 10 12 12 10 11 10 10 12 11 10 11 12 12 11 10 11 12 10 11 10 10 12 12
10 11 10 10 73 11 10 11 12 12 11 10 11 12 10 11 10 10 12 12 10 11 10 10 12 11 10 11 12 12 11 10 11 12 10 11 10 10 12 12
10 11 10 10 73 11 10 11 12 12 11 10 11 12 10 11 10 10 12 12 10 11 10 10 12 11 10 11 12 12 11 10 11 12 10 11 10 10 12 12